++++++++++-----
++++++++++-----
++++++++++++++-
++++++++++++++-
---+++++++++---
++++++++--++++-
+++++++---++++-
----+++---++++-
---+++++++++++-
++++++----+++++
---------------