l---------------n
l---------------n
l++++++++++++++-n
l++++++++++++++-n
l---+++++++++---n
l++++++++--++++-n
l+++++++---++++-n
l----+++---++++-n
l---+++++++++++-n
l++++++----+++++n
l---------------n